harmed: ferit
middle weight: pes mitjà
bogus: fals
dizzying: vertiginós
heights: alçades
tailored suit: vestit a mesura
ring: anell
warden: guardià
jail: presó
treated: tractat
instead: en canvi
breaking down: trencat
powerless: impotent
surrender: rendició
belief: creença
choices: opció
anger: ràbia
rage: ràbia
grove: bosc
parole hearings: audiències de llibertat condicional
lag: retard
fight: lluitar
ruined: arruinat
improved: millorat
trials: assaigs
overturn: bolcat
depths: profunditats
harm: danyar
reject: rebutjar
wits: enginy
facing: enfrontar-se
toughest: més dur
harsh: dures
unyield: sense contacte
soil: sòl
prairies: prades
cherry: cirera
upbeat: optimista
promptly: inmediatament
employee: empleat
careless: descurat
mistake: errada
avoid: evitar
shift: canvi
training: entreteniment
messed up: en mal estat
awful: horrible
hopeless: sense esperança
crazy: boig
relinquished: renunciat
inmate: pres
contender: contendent
biased: tendenciat
trial: judici
brought: portat, passat de bing, portar
instead breaking down: en lloc de trencar
bleak: desolador

